
1111111111111111111
11W111W0000E0001111
1C0111C101111101111
1101111000P001011C1
11C001101C1101000W1
1111000000001111011
1CW0000111000000011
1111001111111C11111
1111111111111111111