

11111111111111
11111C11001111
101C0W000000C1
1C001111111111
110001E0100001
1P010W0000C001
11111111111111


