111111111111111111
110000000110000101
1111111P11111C1111
1E111C100100000111
100010001101111111
111000100000011111
111111111111111111