


1111111
101C0P1
1C00011
11001E1
1010001
1111111


