1111111
10101P1
1000101
11001E1
11101C1
1111111