1111111
101C1C1
1P10101
1C0E101
11100C1
1111111