1111111
101C1C1
1P10111
1C0E111
1111111
1111111