1111111
101C1P1
1C00001
11001E1
11101C1
1111111