1111111
1E1C1C1
1P00101
110C101
11100C1
1111111