asd
11111111
1E0C0001
1PC11111
11111111
