111111111
100000011
1P001E111
111P1C111
111111111