111111111
1E0000011
1P001E111
11111C111
111111111