111111111
1000E0001
1P0011111
11111C111
111111111