111111111
100000011
1P001E111
111110111
111111111