111111111
100000011
1P0010111
11111C111
111111111