111111111
100000011
10001E111
11111C111
111111111