1111111
1000E11
1C11111
1000001
1000111
10111P1
1011101
1001C01
1010011
1000001
1111111