11111111111111111111111111111111111111111
10000000000000000000000000000000000000001
1111111111111111111111111111111111P111111
11CCCCCCCCCCCC111111111111111111110000001
11111110000000000000000000000000000111111
1111111111111111ECCC000000000000000000001
11111111111111111111111111111111111111111