111111111
100000p11
1P001E111
11111C111
111111111